#######################################################################################
#               #                        #                #   #                       #
#               #                        # ################   # ##                    #
#               #                        # #                  # ##                    #
#               #                        #                ##### ##                    #
#               #                        ################       ##                    #
#               #                        #       #          ######                    #
#######  #########################       #  #    ##              #                    #
#           #####                #       #  ##################   ##########  ##########
#           #####                #       #                               #            #
#           #####                #       ##############  #######################  #####
#                                        #           #   #                            #
#           #####                #       #  ###  #####  ##                       ######
#           ######################          ##          ##                            #
####################################################################################  #
#   #                  #             #       ## ####     ###                   #      #
#   #                  #             #       ##          ###                       ####
#   # #                #             #                   ###                          #
#   # #                #             #       ## ####     ###                          #
#   # #                #                     ## ####                                  #
#   # #                              #######################                          #
#     #                #             #                     #                          #
#   ###                #             #                     #                          #
#   # #                #             #                     #                          #
#   # #                #             #                    #############################
#   # ##################             #                 #  ##                          #
#   #     #             ########################       #  ##                          #
#   #     #   #####  #####           #         #       #  ##                          #
#   #     #   #       ####           #         #       #  ##                          #
#   #         #       ####           #         #       #  ##                          #
#         #   #       ####           #         #       #                              #
#####         #                                        #  ##                          #
#######################################################################################